NO ./textures/assets/north_texture.xpm
SO ./textures/assets/south_texture.xpm
WE ./textures/assets/west_texture.xpm
EA ./textures/assets/east_texture.xpm

F 220,100,0
C 225,30,0

111111
100101
101011
100S01
111110